###########
#P#  O#   #
# ### #B# #
#       # #
###B#####B#
#  O#   O #
#B###B#####
#   # #   #
###B# # #B#
#    O  #G#
###########